11111111111111
10000000000001
10000111100001
10000000000001
10100000000101
101000X0000101
10100000000101
10100000000001
10000111100001
11111111111111
